OOOOOOOOOOOOOOOOOOO
OXO.O.O.O.O.O.O.O.O
O.O.O . O.O.O.O.O.O
O.O.O.O.O.O.O.O.O.O
O.O.O.O.O.O.O . O.O
O.O.O.O.O.O.O.O.O.O
O.O . O.O.O.O.O.O.O
O.O.O.O.O.O . O.O.O
O.O.O.O.O.O.O.O.O.O
O.O.O.O . O.O.O.O.O
O.O.O.O.O.O.O.O . O
O . O.O.O.O.O.O.O.O
O.O.O.O.O . O.O.O.U
OOOOOOOOOOOOOOOOOOO
